                        F 255              ,        255           ,        255
           NO                         ./textures/path_to_the_north_texture





              C 255,     255,         255                



                       SO                         ./textures/path_to_the_south_texture                      
EA         ./textures/path_to_the_east_texture                                
         WE            ./textures/path_to_the_west_texture 


         1111111111111111111111111
         1000000000110000000000001
         1011000001110000000000001
         1001000000000000000000001
111111111011000001110000000000001
1S0000000011000001110111111111111
11110111111111011100000010001
11110111111111011101010010001
11000000110101011100000010001
10000000000000001100000010001
10000000000000001101010010001
110000011101010111110111100111
11110111 1110101 101111010001
11111111 1111111 111111111111