

                           SO                 ./textures/path_to_the_south_texture                                           






              NO                  ./textures/path_to_the_north_texture                            




                        WE                      ./textures/path_to_the_west_texture           


          EA                       ./textures/path_to_the_east_texture                           


C      33     ,        33   ,    32      
F      33     ,        33   ,    32                 
F 220,111    ,      129                              

11111111111111111111111
1000000000000000000000011
 1000000000100000000001
  10000000000000000001


   10000000000010000111
    1000000000000001
     100000S0000001
      100000000001
       1000000001
        10000001
         101101
          1011
          11
